XXXXXXXXXOXXXXXXXXXX
XXXXXXXXXOXXXXXXXXXX
XXXXXXXXXOXXXXXXXXXX
XXXXXXXXXOXXXXXXXXXX
XXXXXXXOOOXXXXXXXXXX
XXXXXXOOXOOOOXXXXXXX
XXXXXXOXXXXXOOXXXXXX
XXXXXXOXOOOOXOOXXXXX
XXXXXXOXOXXOXOXXXXXX
XXXXXXOXOOXOXOXXXXXX
XXXXXXOOXXOOXOXXXXXX
XXXXXXXOOOOXXOXXXXXX
XXXXXXXXXXOOOOXXXXXX
XXXXXOOOOOOXXXXXXXXX
XXXXOOXOOXOXXXXXXXXX
XXXXOOXXXXOOXXXXXXXX
XXXXOOXXXXXOXXXXXXXX
XXOOOOOOOOOXXXXXXXXX
XXXXXXOOXXOOOXXXXXXX
XXXXXXXXXXXXXXXXXXXX
